SO ./img/wolf/eagle.xpm
WE ./img/wolf/colorstone.xpm
NO ./img/wolf/greystone.xpm
EA ./img/wolf/redbrick.xpm
C 54,54,54
F 108,108,108

111111111111111
110100000000W11
100001110010001
101000000010001
111111111111111