SO ./img/wolf/eagle.xpm
WE ./img/wolf/colorstone.xpm


NO ./img/wolf/greystone.xpm

EA ./img/wolf/redbrick.xpm


C 54,54,54
F 108,108,108

111111111111111
100000000000001
100000000000001
100000000000001
1000000N0000001
111111111111111
