SO ./img/wolf/eagle.xpm
WE ./img/wolf/colorstone.xpm
NO ./img/wolf/greystone.xpm
EA ./img/wolf/redbrick.xpm
C 54,54,54
F 108,108,108

111111111111111
10000000S000011
111000000001001
111111111111111