NO ../img/north_texture
SO ../img/south_texture
WE ../img/west_texture
EA ../img/east_texture


F 6,77,0
C 83,83,84

        1111111111111111111111111
        1000000000110000000000001
        1011000001110000000000001
        1001000000000000000000001
111111111011000001110000000000001
100000000011000001110111111111111
111101111111110111000000100011111
111101111111110111010100000011111
11000000110101011100000000W011111
100000000000000011000000100011111
100000000000000011010100100011111
110000011101010111110111100011111
11110111 1110101 1011110100011111
11111111 1111111 1111111111111111
