SO ../img/south_texture
F 126,200,255
WE ../img/west_texture
NO ../img/north_texture
C 100,100,100
EA ../img/east_texture

111111111111111111111111
100000000000000000000001
100000000000000000000001
100000000000100S00000001
100000000001010000000001
100000000000100000000001
100000000000000000000001
111111111111111111111111