NO ../img/north_texture
SO ../img/south_texture
WE ../img/west_texture
EA ../img/east_texture


F 6,77,0
C 83,83,84


1111111111111111
1000000000000001
1011111111111101
1010000000000101
1010000000000101
1010000S00000101
1010000000000101
1010000100000101
1010000000000101
1010000000000101
1011111111111101
1000000000000001
1111111111111111
