SO ../img/south_texture
F 126,200,255
WE ../img/west_texture


NO ../img/north_texture














C ,100,100,100
EA ../img/east_texture

        111111 11111111111111111111
        100001 10011000000000001
        101001111100000000000011
        1000001111000000000000011
11111111101101  101110000000000001
10000000001101   11101111111111111111
11110111111111111100000010001000000011111111
1111011111111101110101S0100010000000111   111
11000000110101011100000010001000000011111111
1000000000000000110000001000100000001
1000000000000000110101001000111111111
1100000111010101 11101111001
11110111 1110101 101111010001
11111111 1111111 111111111111
