NO ../img/north_texture
SO ../img/south_texture
WE ../img/west_texture
EA ../img/east_texture
F 54,250,5
C 5,221,250

        1111111111111111111111111
        1000000000110000000000001
        1011000001110000000000001
        1001000000000000000000001
111111111011000001110000000000001
100000000011000001110111111111111
111101111111110111000000100011111
111101111111110111010100000011111
110000001101010111000000000011111
100000000000000011000000100011111
100000000000000011010100100011111
11000001110101011111011110S011111
11110111 1110101 1011110100011111
11111111 1111111 1111111111111111
