NO ../img/north_texture
SO ../img/south_texture
WE ../img/west_texture
EA ../img/east_texture


F 6,77,0
C 83,83,84

111111111111
100000000001
100000000001
10000000E001
100000000001
100000000001
111111111111
