SO ./img/south_texture.xpmz
F 126,200,255
WE ./img/west_texture.xpm
NO ./img/north_texture.xpm
C 100,100,100
EA ./img/east_texture.xpm

1111111111111111111111111111
1000000000000000000000000001
1000000000000000000000000001
1000000000010000010000000001
1000000000100000001000000001
1000000000000N00000000000001
1000000000000000000000000001
1000000000100000001000000001
1000000000010000010000000001
1000000000000000000000000001
1111111111111111111111111111
