SO ./img/south_texture.xpmz
F 126,200,255
WE ./img/west_texture.xpm
NO ./img/north_texture.xpm
C 100,100,100
EA ./img/east_texture.xpm

111111111111111111111111111111111111
100000100000100101010000000000000001
10N000000000000000000000000000011111
10000000010001000000100000000001
00000000000000000000000000000011
11110000010000000000100000000001
10000000010000000000000000000001
11111111111111111111111111111111
