SO ./img/wolf/eagle.xpm
F 0,0,0
WE ./img/wolf/eagle.xpm
NO ./img/wolf/eagle.xpm
C 0,0,0
EA ./img/wolf/eagle.xpm

111111111111111111111111111111111111
100000100000100101010000000000000001
10N000000000000000000000000000011111
10000000010001000000100000000001
10000000000000000000000000000011
11110000010000000000100000000001
10000000010000000000000000000001
11111111111111111111111111111111
