SO ./img/wolf/eagle.xpm
F 126,200,255
WE ./img/wolf/eagle.xpm
NO ./img/wolf/eagle.xpm
C 100,100,100
EA ./img/wolf/eagle.xpm

111111111111111111111111111111111111
100000100000100101010000000000000001
1100000000000000000000000000000011111
100000000100010001001000000000011
11000000000000001010000000000000011
11000001000000001 100000000001111
1110100000010000010000000000000001
1111111111111111111111111111111111
