SO ./img/south_texture.xpmz
F 126,200,255
WE ./img/west_texture.xpm
NO ./img/north_texture.xpm
C 100,100,100
EA ./img/east_texture.xpm

11111
10001
10E01
10001
11111
