SO ./img/wolf/eagle.xpm
F 108,108,108
WE ./img/wolf/colorstone.xpm
NO ./img/wolf/greystone.xpm
C 54,54,54
EA ./img/wolf/redbrick.xpm

111111111111111
10000000S000011
111000000001001
111111111111111